11111
1P0E1
10101
100C1
11111
