111111111111111111111111
100000000000000000000001
100011111111111111110001
100011111111111111110001
1011000000000000000X1101
101101111111111111101101
101101111111111111101101
101101111111111111101101
101901110000000011101101
10180E110000000011101101
101701110000000011101101
101601110000000011101101
101501110000000011101101
101401110000000011101101
101301111111111111101101
101201111111111111101101
101C00111111111111101101
101100000000000000001101
100010000000111111110001
100011111110111111110001
10000000000P000000000001
111111111111111111111111
