111111111111111111111111
100000000000000000000001
100011111111111111110001
100011111151113111110001
1011000000000000000X1101
101100111011111111001101
101101111111111111108101
101101111111111111101101
101C01110000000011101101
101101110000000011102101
101100110000000011101101
101101110000000011101101
101101110000000011001101
101601110000000011101101
101100111111111111104101
101101111111111111001101
10110010111E111101101101
101100000000000000001101
100011117100111119110001
100011111110111111110001
10000000000P000000000001
111111111111111111111111
