111111111111111111111111
100000000000000000000001
100011111111111111110001
100011111111116111110001
1011000000000000000X1101
101101151111111111101101
101101111111111111101101
101101111111111111101101
101401110000000011701101
101101110000000011101101
101101110000000011101101
101101110000000011101101
101101110000000011101101
101101110000000011108101
101103111111111111101101
101101111111111111901101
10110111111E111111101101
101100000000000000001101
10001111121C111111110001
100011111110111111110001
10000000000P000000000001
111111111111111111111111
