111111111111111111111111
100000000000000000000001
100011111111111111110001
100011111111111111110001
1011000000000000000X1101
101101111114111111101101
101301111111111111501101
101101111111111111101101
101101110000000011101101
101101110000000011101101
101101110000000011101101
101101110000000011101101
101101110000000011101101
101101110000000011601101
101101111111111111101101
101102111111111111101101
1011011111C1E11111101101
101100000000000000001101
100011111110111111110001
100011111110111111110001
10000000000P000000000001
111111111111111111111111
