111111111111111111111111
100000000000000000000001
100011111111111111110001
100011111111111111110001
1011000000000000000X1101
101101111112111111101101
101101111111111111101101
101101111111111111301101
101101110000000011101101
101101110000000011101101
101101110000000011101101
101101110000000011101101
101101110000000011101101
101C01110000000011101101
101101111111111111101101
101101111111111111101101
1011011111E1111111101101
101100000000000000001101
100011111101111111110001
100011111101111111110001
1000000000P0000000000001
111111111111111111111111
